retardation -> lumen
vodka -> smuggle
tylenol -> puzzling
murders -> supersonic
ikea -> oceanographic
penetrated -> goddesses
espn -> passionately
organism -> hombre
carling -> remotes
intel -> touted
ugg -> genealogies
teleflora -> leisurely
hasbro -> disjunction
humps -> poco
raunchy -> bowles
jabra -> chatfield
asics -> unfolds
cowgirl -> busts
pubic -> buzzing
nordstrom -> chia
murderous -> swank
mitsubishi -> aidan
zimmer -> fukuoka
alibaba -> momo
dupont -> kiki
slopes -> incision
orally -> bewitched
len -> jamison
organisms -> irradiated
murdered -> crusher
valium -> brocade
marriott -> bernadette
lego -> subspace
lendingtree -> gaz
flo -> esco
ses -> windscreen
silverado -> kendrick
negro -> nonzero
heinz -> expats
newsletter -> undisputed
testicles -> tou
nazis -> inest
bic -> laboring
dewalt -> crayons
atkins -> microdrive
kitchenaid -> crunchy
tivo -> portlet
siemens -> mosaics
cartier -> friendster
womb -> shortwave
queer -> ubi
fedex -> kravitz
directtv -> pressured
teva -> generics
bose -> welles
wwe -> diversify
rum -> recliner
erotic -> centralize
winston -> antler
tlc -> carats
hanes -> roadmaps
fendi -> steed
peugeot -> blackbird
hyundai -> beckman
lancome -> histone
ericsson -> kds
seaman -> marshfield
pms -> impart
sanyo -> faithless
xfx -> empresa
remington -> philanthropic
razr -> tonnage
virgins -> cadiz
sts -> zaragoza
amtrak -> cleats
opel -> leno
barclays -> pious
pur -> nods
hbo -> mayonnaise
erect -> postman
reuters -> baptiste
ritalin -> filer
titled -> langston
nickelodeon -> prevails
opium -> votive
swarovski -> roto
easyshare -> connell
graco -> unrecognized
perkins -> reassuring
oxo -> autocratic
volkswagen -> coworkers
xerox -> leyland
pantie -> olap
sears -> teenaged
photoshop -> jalan
compaq -> fidel
philips -> grudge
sony -> subtracted
tnt -> deprive
mobil -> wegner
maserati -> partie
xbox -> haifa
hilton -> arched
motorola -> myles
logitech -> helical
billabong -> millie
lesbo -> pessimistic
fila -> softened
usps -> titania
honeywell -> profane
retarded -> photosynthesis
revue -> pulsatile
gto -> frail
jeep -> remanded
titty -> woburn
paddy -> cornelia
hollister -> suonerie
givenchy -> uncheck
lee -> dauphin
rawlings -> brandenburg
mattel -> robo
tbs -> photogenic
viacom -> liberalize
mts -> romanticized
redheads -> endowments
radisson -> unites
iberia -> leadville
adobe -> causation
organizes -> susquehanna
visa -> creationism
gods -> feelin
monsanto -> interfaced
daimler -> rightful
sniper -> vlad
cisco -> consecrate
fingering -> heuristics
tacoma -> illiterate
braun -> adderall
trashy -> buttercream
cialis -> precaution
toyota -> scavenger
sheraton -> concepcion
kia -> sumatra
bosch -> straighten
asus -> psychosis
zanussi -> ludhiana
raytheon -> overheat
yamaha -> plasmon
google -> broder
cummins -> speakup
oprah -> tropico
netscape -> optometric
lamborghini -> healthwise
wanking -> realising
thomasville -> therapeutically
knobs -> begs
hitler -> endoscopy
zippo -> deciduous
playstation -> coolidge
digi -> gyno
footjob -> giver
organizers -> teletext
dyson -> tectonic
lmao -> pocatello
jerking -> gigi
hyatt -> mayflower
citibank -> modeler
samsonite -> firefighting
hsbc -> nickles
dkny -> mclachlan
gucci -> adjuster
dixie -> threonine
lens -> ehrlich
stroke -> tomatometer
pokemon -> mylar
barbie -> traitor
screwed -> redlands
tyco -> orthopaedics
reich -> frodo
samsung -> addon
gillette -> simulcast
panties -> battleground
organs -> notecards
whores -> bhopal
hotmail -> skillset
pollock -> counterclaim
transsexual -> earmarked
bridgestone -> microchip
maybach -> highspeed
telstra -> lowdown
revlon -> cranston
adidas -> trove
pwc -> scaffold
nikon -> peppermill
paxil -> stratified
drunk -> needlepoint
hitachi -> greener
verizon -> critter
bmw -> tikes
orange -> cowley
merida -> bidirectional
title -> corbis
kfc -> mooring
sebring -> unroll
msn -> peking
webmd -> adventurer
lenovo -> kremlin
cadillac -> procured
facials -> urns
heath -> mami
prada -> userinfo
woodland -> encephalitis
stanley -> hydrates
acura -> deteriorating
mapquest -> fingernail
organize -> evacuate
net -> circulatory
maytag -> subtopics
mgm -> texarkana
panty -> fryers
pricewaterhousecoopers -> kenner
organizer -> persecuted
thrust -> libro
shimano -> intimidated
pcp -> mallet
citigroup -> babble
mcafee -> ucf
telus -> twikivariables
lacoste -> zoological
kinky -> elkins
priceline -> niches
nad -> churn
alcatel -> forgery
dhl -> justifying
kodak -> gpu
boeing -> westfall
vonage -> seaweed
ups -> hesitant
assn -> hemscott
ferrari -> candlelight
strip -> matured
daewoo -> sofware
jackass -> foothill
porsche -> haverhill
organic -> mortuary
yasmin -> fondue
itc -> wurlitzer
god -> refinishing
pfizer -> brandeis
cobalt -> ultrafast
chevrolet -> cally
penetrate -> bordered
toshiba -> concertos
nfl -> mccarty
facial -> corneal
bally -> vermilion
camry -> militaria
killings -> kilo
enlargement -> endlessly
nextel -> jagger
lic -> overlooks
swanson -> pereira
snuff -> audley
jerky -> chairmen
oral -> technische
ibm -> chatrooms
lycos -> jessy
vicodin -> shari
vans -> morehead
adecco -> congestive
organization -> prized
heroin -> beggs
swatch -> starfish
acer -> modulo
zoloft -> keaton
tramp -> avondale
sadism -> energized
panasonic -> cognac
marlboro -> munch
coolpix -> disguises
dickies -> harriers
spectra -> junit
lexus -> fillet
strips -> wafers
omg -> angstroms
thomson -> musicmatch
garmin -> dwellers
dia -> jumble
breitling -> enlist
lipitor -> elmwood
timex -> exch
lancer -> sportsline
tim -> macular
nike -> siti
davidoff -> celestron
town -> unmanageable
zappos -> messina
titan -> porters
nasdaq -> tonal
mtv -> minnetonka
plus -> micheal
wtf -> paraffin
prozac -> romney
winchester -> opioid
zyrtec -> ephraim
rtl -> longwell
nestle -> airwaves
lufthansa -> boro
virgin -> feats
hoover -> widened
casio -> grasping
renault -> tropez
bellsouth -> inflatables
nissan -> kurdistan
thinkpad -> grosvenor
microsoft -> buscadores
titles -> bolle
zelda -> sagradas
ipod -> drinker
sucked -> tianjin
reynolds -> robber
winfield -> millet
bullshit -> zionism
bayer -> denunciation
stripped -> signatory
timberland -> overboard
kaiser -> thorns
quaker -> empirically
myspace -> eroticos
ing -> webmasterworld
mazda -> convocation
michelin -> toning
sexo -> enlightening
honda -> chica
baxter -> shone
ritz -> marketplaces
colgate -> mcgovern
epson -> regained
rolex -> murfreesboro
jameson -> sysadmin
lesbos -> dubya
tesco -> squeal
magnavox -> turbidity
valtrex -> geriatrics
jockey -> budweiser
pots -> kors
sexe -> mille
memorex -> bales
femdom -> neiman
skype -> preps
matchbox -> solidification
hooters -> hologram
bbc -> nance
kelkoo -> loki
sandals -> biogeochemical
kohler -> utterance
qualcomm -> snowball
maxi -> iredell
massa -> dexterity
walmart -> hasty
ducati -> ducking
quicken -> salaire
vodafone -> hijacked
shemales -> continuance
travelocity -> centerline
phillips -> scrape
electrolux -> layering
pepsi -> leafy
suzuki -> infrequent
novartis -> disjoint
hallmark -> donner
bce -> roadkill
outback -> compre
comcast -> goodbyes
nasa -> olivetti
staples -> perusing
moschino -> setups
gals -> leech
organizing -> arion
forbes -> ariba
dykes -> duels
sandisk -> cypriot
kappa -> icalendar
martini -> karla
vomiting -> astor
johnson -> villainous
pentium -> playmates
pontiac -> mesozoic
fischer -> mcfadden
atari -> sanitizing
slope -> mouthpiece
hiv -> apologetics
sexes -> wading
ricoh -> tage
kvm -> cutaneous
volvo -> openldap
nintendo -> revamped
xanax -> dislikes
reebok -> exemplified
vulgar -> excellency
qwest -> ferrara
chanel -> fascia
pot -> dork
ubs -> pretreatment
miller -> camargo
norton -> lehmann
netflix -> firsthand
strokes -> rookies
maxima -> neale
hump -> pythagorean
cumshots -> progressives
fuchs -> overton
teflon -> marche
kenmore -> pajama
organics -> barth
vtech -> adresse
mastercard -> sigs
assy -> memoriam
passat -> ashtray
foreskin -> psychoanalysis
sexy -> trisha
nascar -> bizarr
jetta -> gujarati
stripping -> characterizing
duracell -> trium
kraft -> gaspari
craigslist -> dieses
inbred -> sealant
aviator -> timberwolves
itunes -> brixton
herpes -> matisse
ezine -> paramilitaries
versace -> reincarnation
doubletree -> hugging
lycra -> rolleyes
orgy -> anglicans
imax -> sudo
hertz -> terrazzo
pauls -> soundcraft
saab -> midrange
tata -> moisturizer
sanford -> curfew
pixar -> disagrees
armani -> interferences
organizations -> distracting
masterbating -> crabtree
dior -> bookbinding
devry -> bangladeshi
tyson -> drawstring
dicke -> spankings
polaroid -> kava
nbc -> mcdonell
birkenstock -> conveniences
starbucks -> tanzanite
buick -> iwork
rockport -> linger
mead -> nikolai
tvs -> underserved
quiksilver -> brazillian
celebrex -> abstention
bondage -> cabarrus
fats -> statenvertaling
ebay -> fueling
weiner -> punishing
travelodge -> boces
erected -> shoebox
htc -> conley
qantas -> epo
subaru -> seedling
westinghouse -> corals
disney -> schilling
burberry -> pathologist
nokia -> limewire
playboy -> conservationist
pbs -> bandwidths
audi -> prematurely
gal -> maneuvers
organ -> vivaldi
midas -> reconvened
sfr -> thelma
kpmg -> callmanager
rogers -> desking
president -> lifesaver
avis -> quaternary
amg -> othello
guido -> objc
jvc -> maniacs
skechers -> affectionate
